NO              ./path_to_the_north_texture

WE ./path_to_the_west_texture
F                                   220,100,0
C               225,30,0



SO        		 ./path_to_the_south_texture


EA ./path_to_the_east_texture





        1111111111111111111111111
	  	1000000000110000000000001
        1011000001110000000000001
		1001000000000000000000001
11111111011000001110000000000001
100000000011000001110111111111111
11110111111111011100000010001
11110111111111011101010000001
11000000110101011100000010001
10000000000000001100000010001
10000000000000001101010010001
11110111111111000000000010001
1111011111111100001010010001
11000000110101011100000010001
10000000000000001100000010001
1100000111010101111101111000111
1111W111 1110101 101111010001
111111111 1111111 111111111111
