NO              ./img_no.xpm

WE ./img_we.xpm


SO        		 ./img_so.xpm


EA ./img_ea.xpm


F                                   0,200,0

C               0,0,200

		1111111111111111111111111
	  	1000000000110000000000001
        1011000001110000000000001
		1001000000000000000000001
111111110110000011100000000000011
100000000011000001110111111111111
11110111111111011100000010001
11110111111111011101010000001
11000000110101011100000010001
10000000000000001100000010001
10000000000000001101010010001
11110111111111000000000010001
1111011111111100001010010001
11000000110101011100000010001
10000000000000001100000010001
1100000111010101111101111000111
1111N111 1110101 101111010001
111111111 111111111 11111111111
